+------------+
|A           |
|########### |
|          # |
| ######## # |
| #      # # |
| # ####     |
| #      ####|
| ########   |
|          ##|
| ###### ####|
| ## ########|
|           B|
+------------+
